-	ー
~	〜
.	。
,	、
[	「
]	」
w		こ
こl	ご
e		し
しl	じ
r		て
y		つ
つl	づ
u	ん
i	い
o	の
p	り
@		ち
ちl	ぢ
a		は
はl	ば
s		か
かl	が
f		と
とl	ど
g		た
たl	だ
h		く
くl	ぐ
j	う
;		き
きl	ぎ
:	れ
z		す
すl	ず
x		け
けl	げ
c	に
v	な
b		さ
さl	ざ
n	っ
m	る
,	，
.	。
kq	ぁ
kw		ひ
ke		ほ
kr		ふ
kt	め
dy	ぬ
du	え
di	み
do	や
dp	ぇ
d@	「
ka	ぃ
ks	を
kd	ら
kf	あ
kg	よ
dh	ま
dj	お
dk	も
dl	わ
d;	ゆ
d:	」
kz	ぅ
kx		へ
kc		せ
kv	ゅ
kb	ゃ
dn	む
dm	ろ
d,	ね
d.	ー
d/	ぉ
d_	・
ひl	び
ほl	ぼ
ふ/	ぷ
は/	ぱ
へ/	ぺ
ひ/	ぴ
ほ/	ぽ
ふl	ぶ
へl	べ
せl	ぜ
q		そ
そl	ぞ
てl	で
t	ょ
